played on 9th Jan
back to main page 
Here is the playlist for Friday 9th January 1998 
  Space - Avenging Angels 
  Spiritualized - I thiink I'm in Love (Chemical Brothers remix) 
  Elastica - Stutter 
  Renegade Master - Wildchild 98 (Fatboy Slim mix) 
  Cornershop - Brimful of Asha (not Fatbot Slim mix) 
  Radiohead - No Surprises 
  Death in Vegas - Opium Shuffle (Monkey Mafia mix) 
  Catherine Wheel - Delicious 
  Rialto - Untouchable 
  Movin Melodies - Flatliner (We've got a pulse) 
  Super Furry Animals - Demons 
  Pills - Rock Me 
  NEWS 
  Man... or Astroman - Destination Venus 
  David Holmes - Don't Die Just Yet 
  Baby Birkin - melo melo 
  Snug - Ode to the Dat 
  Lo-Fidelity Allstars - Kool Rok Bass 
  Catherine Wheel + Tanya Donelly - Judas Staring at the Sun 
  Blur - On Your Own (Crouch End Broadway mix) 

Edgeclub is broadcast Saturday nights (10pm-3am) on 94.5 KDGE "The Edge" -
Dallas/Ft. Worth

Playlist for Edgeclub with DJ Merritt -- 11/27/99

Artist - Song(mix) - (Label)

10:PM

Prodigy - Poison(rat poison) - (XL)
Dust Brothers - "This Is Your Life" - (Restless)
Propellerheads feat Jungle Bros - "Take California" - (Dreamworks)
Everything But The Girl - "Blame" - (Atlantic)
Les Rhythm Digitales - "Soft Machine" - (Astralwerks)
BT - "Movement In Still Life" - (Pioneer)
The Catalyst feat Aaron Axelsen - "The Dawn" - (Risk)
Filter - "Take A Picture(hybrid)" - (F-111)
Double Six - "Breakdown" - (Multiply)
DJ Merritt - "The Funktion" - (white)

11:PM

Groove Armada - "I See You Baby" - (Jive Electro)
Beth Orton - "Central Resurection(deep dish)" - (Arista)
Scraffy Traxx - "I Preach To Party" - (Island)
The Wildchild Experience - "Jump To My Beat" -(Loaded)
Basement Jaxx - "Jump & Shout" - (Astralwerks)
Hollis P. Monroe - "I'm Lonely(roadblock)" - (Stickman)
BT - "Dreaming" - (Pioneer)
Atlantis - "See You In The Next Life" - (Infusion)
Space Raiders - "The Disco Doctor(phats & small)" - (Medicine Label)
Leftfield - "Phat Planet" - (Columbia)
Tungsten - "Carbine" - (Future Groove)
DJ Icey - "Hot Stop" - (Zone)

12:AM
Midnight House Classic:
Steve "Silk" Hurley - "Jack Your Body" - (DJ International)

Richie Hawtin - "Orange" - (Nova Mute)
Brainchild - "Symetry C(mike koglin)" - (Multiply)
**Late Night Guest Mix with DJ Mundo (Wikiddrama Records/Dallas)**
Mundo - "Disturbance" - (Wikiddrama)
Teebee - "Invasion" - (Juice)
Slip - "Once Again" - (Jedi Reks)
DJ Slip - "Doomsday" - (Syrous)
Mundo - "Strike!" - (Wikiddrama)
Armand Van Helden - "Ain't Armand" - (AV8)
Fellowship - "Delusions" - (Phuturistic Bluez